██████████████████████████████████████████████████████████████████████
            ██              ██                              ██      ██
██████████  ██████████  ██  ██  ██████████████  ██████████  ██  ██  ██
██  ██      ██          ██  ██  ██          ██  ██      ██      ██  ██
██  ██  ██████  ██  ██████████  ██  ██████  ██  ██  ██  ██████████  ██
██  ██      ██  ██  ██          ██  ██  ██  ██      ██  ██          ██
██  ██████  ██  ██████  ██████████  ██  ██  ██████████████  ██████  ██
██      ██  ██                  ██  ██                      ██  ██  ██
██  ██████  ██████████████████  ██  ██  ██████████████████████  ██  ██
██      ██          ██      ██  ██  ██  ██              ██      ██  ██
██  ██  ██████████  ██  ██████  ██  ██████  ██████████  ██  ██████  ██
██  ██      ██      ██          ██  ██              ██  ██          ██
██  ██  ██████  ██████  ██████████  ██  ██████████████  ██████████████
██  ██  ██      ██          ██  ██      ██          ██  ██          ██
██  ██  ██  ██████████████  ██  ██████████  ██████  ██  ██  ██████  ██
██  ██  ██              ██      ██          ██      ██  ██  ██  ██  ██
██  ██  ██████████████  ██████  ██  ██████████  ██████  ██  ██  ██  ██
██  ██              ██  ██  ██  ██      ██      ██              ██  ██
██  ██████████  ██████  ██  ██  ██████  ██  ██████████████████████  ██
██  ██      ██          ██  ██      ██  ██                          ██
██  ██████  ██████████████  ██████  ██  ██████████████████████████  ██
██      ██          ██              ██      ██              ██      ██
██████  ██████  ██  ██  ██████████████████  ██████████  ██  ██  ██████
██  ██      ██  ██  ██  ██          ██      ██      ██  ██  ██      ██
██  ██████  ██████  ██  ██████  ██████  ██████  ██  ██  ██  ██████  ██
██      ██      ██  ██          ██      ██      ██      ██      ██  ██
██  ██  ██████  ██  ██████████  ██  ██████████  ██████████████  ██  ██
██  ██      ██  ██  ██          ██  ██          ██  ██          ██  ██
██  ██████████  ██  ██  ██████████  ██  ██  ██████  ██  ██████████  ██
██      ██      ██      ██          ██  ██      ██  ██  ██          ██
██████  ██  ██████  ██████  ██████████  ██████  ██  ██  ██  ██████████
██      ██      ██      ██  ██  ██      ██      ██      ██            
██  ██████████  ██████████  ██  ██  ██████  ██████████████████████  ██
██                          ██          ██                          ██
██████████████████████████████████████████████████████████████████████